{
  "fields" : [
    [0, 0, 0, 0, 2, 0, 0, 0, 0, 0 ],
    [0, 2, 4, 4, 4, 0, 6, 6, 2, 0 ],
    [0, 2, 0, 0, 0, 0, 8, 0, 2, 0 ],
    [0, 2, 0, 0, 0, 0, 8, 0, 2, 0 ],
    [0, 2, 0, 0, 6, 6, 8, 0, 2, 0 ],
    [0, 2, 0, 0, 8, 0, 0, 0, 2, 0 ],
    [0, 2, 0, 0, 8, 0, 0, 0, 2, 0 ],
    [0, 2, 0, 0, 8, 0, 2, 4, 4, 0 ],
    [0, 6, 6, 6, 8, 0, 2, 0, 0, 0 ],
    [0, 0, 0, 0, 0, 0, 2, 0, 0, 0 ]
  ],
  "start" : { "x": 4, "y": 0 },
  "end" : { "x": 6, "y": 9 }
}