{
  "fields" : [
    [0, 2, 0, 0, 0, 0, 0, 0, 0, 0 ],
    [0, 2, 0, 0, 0, 0, 0, 0, 0, 0 ],
    [0, 6, 6, 6, 6, 6, 6, 6, 2, 0 ],
    [0, 0, 0, 0, 0, 0, 0, 0, 2, 0 ],
    [0, 0, 0, 0, 0, 0, 0, 0, 2, 0 ],
    [0, 2, 4, 4, 4, 4, 4, 4, 4, 0 ],
    [0, 2, 0, 0, 0, 0, 0, 0, 0, 0 ],
    [0, 6, 6, 6, 6, 6, 6, 6, 2, 0 ],
    [0, 0, 0, 0, 0, 0, 0, 0, 2, 0 ],
    [0, 0, 0, 0, 0, 0, 0, 0, 2, 0 ]
  ],
  "start" : { "x": 1, "y": 0 },
  "end" : { "x": 8, "y": 9 }
}