{
  "fields" : [
    [0, 0, 0, 0, 0, 0, 0, 0, 0, 0 ],
    [0, 0, 0, 0, 0, 0, 0, 0, 0, 0 ],
    [6, 6, 6, 6, 6, 6, 6, 2, 0, 0 ],
    [0, 0, 0, 0, 0, 0, 0, 2, 0, 0 ],
    [0, 0, 0, 0, 0, 0, 0, 2, 0, 0 ],
    [0, 0, 0, 0, 0, 0, 0, 2, 0, 0 ],
    [0, 0, 0, 0, 0, 0, 0, 2, 0, 0 ],
    [4, 4, 4, 4, 4, 4, 4, 4, 0, 0 ],
    [0, 0, 0, 0, 0, 0, 0, 0, 0, 0 ],
    [0, 0, 0, 0, 0, 0, 0, 0, 0, 0 ]
  ],
  "start" : { "x": 0, "y": 2 },
  "end" : { "x": 0, "y": 7 }
}